NO ./assets/brick.xpm



SO ./assets/blue.xpm


WE ./assets/grey.xpm








EA ./assets/wood.xpm
F 224,172,105




C 205,249,255












        1111111111111111111111111
        1000000000110000000000001
        1011000001110000000000001
        1001000000000000000000001
111111111011000001110000000000001
100000000011000001110111110111111
111101111111111111000000100011
111101111111111 111010100100011
110000001101011 111000000100011
100000000000001111000000100011
100000000000000011010100100011
11000001110101011111011110N0111
11110111 1110101 101111010001
11111111 1111111 111111111111
