NO ./assets/argentine.xpm
SO ./assets/bresil.xpm
WE ./assets/france.xpm
EA ./assets/portugal.xpm

F 220,100,0
C 225,30,0

1111111111
1000000001
1000100001
1001110001
1000100001
1000N00001
1111111111
